"filename", "language", "JavaScript", "JavaScript JSX", "comment", "blank", "total"
"c:\Users\annem\Documents\Programming\pathfinder-sheet\src\assets\Characters\Functions\Gameplay\ac.js", "JavaScript", 7, 0, 0, 2, 9
"c:\Users\annem\Documents\Programming\pathfinder-sheet\src\assets\Characters\Functions\Gameplay\attributes.js", "JavaScript", 4, 0, 0, 0, 4
"c:\Users\annem\Documents\Programming\pathfinder-sheet\src\assets\Characters\Functions\Gameplay\hp.js", "JavaScript", 10, 0, 0, 1, 11
"c:\Users\annem\Documents\Programming\pathfinder-sheet\src\assets\Characters\Functions\Gameplay\saves.js", "JavaScript", 27, 0, 0, 8, 35
"c:\Users\annem\Documents\Programming\pathfinder-sheet\src\assets\Characters\Functions\attributes.js", "JavaScript", -4, 0, 0, 0, -4
"c:\Users\annem\Documents\Programming\pathfinder-sheet\src\assets\Characters\Functions\initialiseChar.js", "JavaScript", 39, 0, 4, 13, 56
"c:\Users\annem\Documents\Programming\pathfinder-sheet\src\assets\Characters\Sheet Tabs\CombatTab.jsx", "JavaScript JSX", 0, -15, -3, -2, -20
"c:\Users\annem\Documents\Programming\pathfinder-sheet\src\assets\Characters\Sheet Tabs\Combat\CombatTab.jsx", "JavaScript JSX", 0, 29, 3, 2, 34
"c:\Users\annem\Documents\Programming\pathfinder-sheet\src\assets\Characters\Sheet Tabs\Combat\SavesTable.jsx", "JavaScript JSX", 0, 46, 2, 1, 49
"Total", "-", 83, 60, 6, 25, 174